R 10000 10000
NO ./textures/minecraft/rougth_andesite.xpm
SO ./textures/minecraft/stone_too_big.xpm
WE ./textures/minecraft/andesite.xpm
EA ./textures/minecraft/cobblestone_too_big.xpm
S ./textures/minecraft/real_creeper.xpm
F 255,100,0
C 100,100,255

11111111111111111111111111111111111111111111111
10000000000022200000000000000111111111122111111
10000000000000000000000000000111111110000011111
10000000000000000000000000000111111000000001111
11111111111100011111111111111111100000000000011
12000001200000000000000000000000000000000000021
10000001000000000000000000000000000000000000021
10000000000000022200000000000111100000000000011
10000000000000022200000000000111111000000000111
10000001000000000000000000000111111110000001111
12000001200000000000000000002111111111222111111
11111111111111111000111111111111111111111111111
11111111111111120000021111111111111111111111111
11111111111110000000000001111111111111111111111
111111111111100000N0000001111111111111111111111
11111111111111111111111111111111111111111111111
